############
#1...#.....#
#....#..#..#
#....#..#..#
#..........#
#..##......#
#......##..#
#.....#...2#
############

